keys	keys, house keys, radar key, my keys, front door keys, keychain, door keys, key, set of keys
fob	security fob
wallet	black small wallet, my purse, my wallet, ladies purse, money pouch, coin purse, wallet for bus pass cards and money, i d wallet, ipod in wallet, walletv, wallet, purse
money clip	money clip
airpods	airpod pro, single airpod, apple airpods, pro
airpods	earphones, apple headphones, apple earpods, airpods, my airpod pros case, iphone air pods, airpods pro charging case, airpod case, airpods, my airpods, airpods case, earpods, apple airpods case
headphones	blue headphones, my headphones, headphone, bose wireless headphones, headset, my sennheiser pxc 350-2, headphones
earphones	wireless earphones, bone conducting headset, bose earpods, my muse s headband
headphone case	headphone case
door	front door, back door, house door, front door to house, door, my front door, shed door, front door from outside
remote control	remote, tv remote, apple tv remote, amazon remote control, television remote control, remote control, virgin remote control, tv remote control, samsung tv remote control, presentation remote, sky q remote, clickr, fire stick remote, control, television control, remote tv, remote comtrol, apple tv ii remote control, t. v. remote control
keyboard	blue tooth keyboard, bluetooth keyboard, my keyboard, apple wireless keyboard, mini bluetooth keyboard, portable keyboard, keyboard
stylus	stylus, apple pencil
controller	ps4 controller
recorder	digital recorder, dictaphone, handheld police scanner
audio labeller  pen friend
laptop	my laptop, laptop
ipad	ipad, ipad pro
CD	compact disc
iphone	phone, mobile phone, iphone 6, apple mobile phone, i phone 11 pro, iphone in case, iphone, cell phone, work phone, phone case
mouse	mouse
radio	digital dab radio, dab radio, speaker, radio, my bose bluetooth speaker
phone stand	phone stand, nobile phone stand, ipod stand, iphone stand
memory stick	memory stick, usb c dongle, usb stick, usb
phone charger	apple phone charger, phone charger
pruning tool	scissors, secateurs
car	car, my sisters car
garden wall	garden wall
shed	garden shed
post box	local post box, post box
litter and dog waste bin	litter and dog waste bin
bin	wheely bin, wheelie bin, black bin, recycling bin, bin, brown wheelie bin
shoes	slippers, nike trainers, my shoes, boot, trainers, trainer shoe, slipper, my trainers, shoes, running shoes
socks	socks, sock
top	black strappy vest, t-shirts
watch	watch, wrist watch, apple watch, apple wath, risk watch, my apple watch
clock	my clock
gloves	gloves, winter gloves
mask	face mask, covid mask, my purple mask, blue facemask
sleep mask	sleep mask
sunglasses	sunglasses, my wraparound sunglasses, dark glasses
glasses	reading glasses, glasses, eye glasses, spectacles
glasses case	sunglasses case, glasses case, eyewear case
glasses cleaning wipe	glasses cleaning wipe
tissue box	tissue box
birth control	condom box
hat	baseball cap, cap, orange skullcap, my tilly hat, hat, my tilly hat upside down
hand gel	hand gel
lotion	lotion bottle
hairbrush	hairbrush, comb, hair brush
perfume	perfume
deodorant	deodorant
make up	make up
nail polish	clear nail varnish
lipstick	lipstick
lip balm	chap stick, lip balm
tweezers	tweezers
nail clipper	finger nail clipper 
headband	hair clip, headband
toothbrush	toothbrush, electric toothbrush
pills	medication, blister pack of painkillers, tablets, money, aspirin vs tylenol, aspirin, pill bottle, my pill dosette, buckleys, box of tablets
asthma device	inhaler, insulin pen, spacer
eye drops	eye drops
alcohol wipes	alcohol wipe, skip prep
necklace	necklace
bracelet	brown leather bracelet, ladies silver bracelet
earing	favourite earings
ring	silver male wedding band
quartz	clear quartz
backpack	backpack, my work backpack, back pack, work backpack, numb bag
bag	work bag, bag, shoulder bag, bum bag
sports bag	ports bag, sport bago
cane	symbol cane, black mobility cane, my cane, white mobility came, folded white cane, long cane, cane, folded cane, folded long guide cane, p939411 white cane, white came, visibility stick, mobility, mobility cane, white cane
braille reading device	orbit braille reader and notetaker, orbit reader 20 braille display, braillepen slim braille keyboard, braille orbit reader, braille note, my braille displat
talking book players    victor stream book reader, solo audiobook player, victor reader stream, rnib talking book envelope
hearing aid	my hearing aid, hearing aid
magnifying glass	magnifier, pocket magnifying glass
dog lead	guide dog play cola, dogs lead, guide dog harness, retractable dog lead, leash, guide dog harness, dog lead, dogs, running tether
artificial eye	blue artificial eye, green artificial eye
screwdriver	screwdriver, small space screwdriver, small screwdriver, spanner, wood phillips head, pex plumbers pliers, wood screw phillips head
hand saw	hand saw
drill	battery drill
measuring tape	tape measure
ruler	ruler
sander	electric sanding disc
miter saw	miter saw
grease	valve oil, slide grease
cooker	cooker
microwave	microwave
toaster	toaster
kettle	kettle, one cup kettle
fridge	fridge, fridge freezer indicator
washing machine	adaptive washing machine, washing machine, tumble dryer, adaptive dryer, tumble dry setting washing machine, washing machine setting
television	tv unit, flat screen television, tv, smarttv, television
bed	bed
sofa	sofa
cushion	cushion
storage unit	shelf unit with things, wardrobe
table	dining table setup, desk, garden table
bench	garden bench
mirror	mirror
fan	table fan
basket	knitting basket, washing basket, basket
phone	home phone, cordless phone
tredmill	tred mill
exercise bench	exercise bench
skipping rope	skipping rope
gate	stairgate, back patio gate
liquid level indicator	liquid level indicator, water level sensor
watering can	watering can, watering
vase	vase with flowers
peeler	veg peeler
bottle opener	bottle opener, corkscrew
cup	mug, personal mug, cup again, coffee mug, toddler cup, styrofoam cup, my mug, my cup
glass	pint glass, wine glass, glass
measuring cup	12 measuring cup, 13 measuring cup, 14 measuring cup, 1 cup measuring cup, measuring spoon, measuring spoons
knife	sharp knife
socket	wall plug
needle	large sewing needle, knitting needle
thread cone	embroidery thread cone
hole punch	hole punch
pencil case	pencil case
paperclip	paperclips
playing cards	uno cards
marker	lime green marker, yellow marker, pink marker, migenta marker, reptile green marker, pen
bottles of alcoholic drink	prosecco, jd whisky bottle, bottle of alcoholic drink, vagabond ale bottle
lighter	lighter
vape	vape pen, cannabis vape battery
tin	baked bean tin
banana	banana
mayonnaise	mayonnaise jar
mustard	mustard
rice	rice
noodles	chicken instant noodles
salt and pepper shaker	pepper shaker, pink himalayan salt, mediterranean sea salt, salt grinder, salt shaker, salt and pepper shaker
tea	tea, cranberry cream tea
coffee pods	cappuccino pods
soda can	mountain dew can
water bottle	my water bottle, bottle, pop bottle, green water bottle, water bottle, bottle of water, clean canteen stainless steel water bottle
cleaner	pinesol cleaner
fish food	fish food
cat	cat 
guide dog	guide dog, my flee
dog poo	dog poo
dog toy	dog streetball, dog toy, adaptive tennis ball
bus stop	ottawa bus stop, bus stop sign
tambourine	av tambourine
grinder	grinder
journal	journal
book	book
blanket	fluffy blanket
